147 147 147 147 147 147 147 147 147 147 147 147 147 147 147 147 147 147 147 147 147 147 147 147 147 147 147 147 147 147
147 147 151 163 163 163 163 163 163 163 163 163 167 147 147 147 151 163 163 163 163 163 163 163 163 163 163 167 147 147
147 147 150 0 0 8 141 142 142 142 142 143 18 147 147 147 38 70 70 180 181 181 181 181 181 181 181 183 147 147
147 147 150 0 0 26 157 158 158 158 158 159 34 147 147 147 38 0 0 196 197 197 197 197 197 197 197 199 147 147
147 147 150 0 0 26 157 158 158 158 158 159 34 147 147 151 53 0 0 212 213 213 230 197 197 197 197 199 147 147
147 147 150 0 0 26 173 174 174 174 174 175 50 163 163 53 0 0 0 0 0 71 212 213 213 213 213 215 147 147
147 147 150 0 0 42 43 59 0 0 58 43 44 0 0 0 0 0 0 0 0 71 0 66 0 0 0 112 147 147
147 147 150 0 0 0 0 0 0 0 0 66 0 0 0 0 0 0 0 0 0 0 0 0 0 0 0 146 147 147
147 147 81 0 0 0 0 0 0 0 0 0 0 0 0 0 0 0 0 0 0 0 0 0 0 0 0 146 147 147
147 147 81 0 0 0 0 0 0 0 0 0 0 0 0 0 0 0 0 0 0 0 0 66 0 20 20 65 147 147
147 147 97 0 0 0 0 0 66 0 0 0 69 33 0 0 0 0 0 0 0 0 0 0 130 132 132 144 147 147
147 147 96 88 88 88 88 88 88 88 88 88 120 49 71 71 0 0 0 66 87 88 88 88 84 164 164 167 147 147
147 147 150 0 0 66 0 0 0 0 0 71 71 0 0 0 0 0 0 0 0 0 0 0 0 177 178 48 147 147
147 147 150 180 181 181 181 181 181 181 190 191 0 0 141 142 142 142 143 0 0 0 0 0 0 193 71 64 147 147
147 147 150 196 197 197 197 197 197 197 206 207 0 68 157 158 158 158 159 0 0 0 0 0 0 193 71 64 147 147
147 147 113 196 197 197 197 197 197 197 222 223 0 68 157 158 158 158 159 0 0 0 0 0 0 193 0 64 147 147
147 147 150 196 197 197 197 197 197 197 197 198 0 68 157 158 158 158 159 0 0 0 0 70 70 193 0 64 147 147
147 147 150 212 213 213 213 213 213 213 213 214 66 0 173 174 174 174 175 0 0 0 70 70 70 193 71 64 147 147
147 147 85 20 20 20 20 20 20 20 20 20 20 20 20 20 20 20 20 20 20 22 22 22 22 176 160 80 147 147
147 147 145 132 132 132 132 132 132 132 132 132 132 132 132 132 132 132 132 132 132 132 132 132 132 132 132 144 147 147
